WWwWWWWWWWWWW
WWRWWWWWWWWWW
WW         WW
WW         WW
WWE    WWWWWW
WW  W  W   WW
WW  W  RP  WW
WW  W      WW
WW  W      WW
WWEEW      WW
WWWWWWWWWWWWW
WWWWWWWWWWWWW
